סמל צורת יישוב,סמל יישוב,שם יישוב,נכנסים,יוצאים,מאזן הגירה פנימית
280,472,אבו גוש,144,85,59
270,473,אבו סנאן,156,196,-40
450,1342,אבו קורינאת (יישוב),226,4,222
450,1375,אבו תלול,1224,0,1224
290,652,אבטין,23,47,-24
370,1275,אבטליון,52,14,38
310,679,אביאל,35,36,-1
310,1115,אביבים,7,18,-11
310,819,אביגדור,48,33,15
310,175,אביחיל,85,83,2
310,2052,אביטל,5,22,-17
310,1070,אביעזר,40,50,-10
370,1220,אבירים,13,16,-3
170,182,אבן יהודה,553,480,73
310,1081,אבן מנחם,17,14,3
310,783,אבן ספיר,17,26,-9
350,400,אבן שמואל,141,40,101
310,4011,אבני איתן,20,27,-7
370,3793,אבני חפץ,99,125,-26
370,3786,אבנת,7,11,-4
370,1311,אבשלום,14,4,10
370,3759,אדורה,19,25,-6
310,113,אדירים,10,6,4
310,1123,אדרת,17,39,-22
310,446,אודים,57,72,-15
320,4010,אודם,9,8,1
310,1046,אוהד,3,10,-7
250,2710,אום אל-פחם,207,313,-106
450,2024,אום אל-קוטוף,20,17,3
290,1358,אום בטין,507,5,502
350,1108,אומן,27,18,9
310,680,אומץ,41,15,26
160,31,אופקים,1499,929,570
320,1294,אור הגנוז,1,16,-15
330,67,אור הנר,41,44,-3
160,2400,אור יהודה,695,1151,-456
170,1020,אור עקיבא,694,544,150
310,780,אורה,41,109,-68
310,2012,אורות,25,32,-7
330,4013,אורטל,13,18,-5
330,403,אורים,27,21,6
180,3760,אורנית,450,412,38
330,278,אושה,6,5,1
170,565,אזור,566,653,-87
350,1157,אחווה,4,11,-7
310,821,אחוזם,17,24,-7
190,1330,אחוזת ברק,125,84,41
310,785,אחיהוד,44,47,-3
310,850,אחיטוב,31,49,-18
310,804,אחיסמך,39,74,-35
310,797,אחיעזר,86,57,29
340,338,איבים,12,79,-67
330,716,אייל,23,9,14
330,77,איילת השחר,30,68,-38
330,294,אילון,63,38,25
330,1126,אילות,18,43,-25
310,49,אילנייה,22,32,-10
150,2600,אילת,2911,3097,-186
370,1336,אירוס,141,8,133
370,3762,איתמר,78,60,18
310,37,איתן,19,23,-4
270,478,אכסאל,99,97,2
450,1339,אל -עזי,10,47,-37
450,1316,אל -עריאן,4,4,0
330,4003,אל -רום,20,14,6
280,1359,אל סייד,1776,5,1771
350,1145,אלומה,28,35,-7
330,330,אלומות,30,18,12
310,1182,אלון הגליל,55,40,15
370,3579,אלון מורה,66,133,-67
190,3604,אלון שבות,123,279,-156
320,429,אלוני אבא,44,36,8
320,4017,אלוני הבשן,10,14,-4
340,868,אלוני יצחק,3,23,-20
330,285,אלונים,25,13,12
310,4002,אלי-עד,37,16,21
370,1365,אליאב,57,1,56
190,41,אליכין,132,154,-22
330,1248,אליפז,11,29,-18
310,730,אליפלט,18,28,-10
310,682,אליקים,39,40,-1
310,204,אלישיב,16,30,-14
310,841,אלישמע,43,77,-34
310,1125,אלמגור,19,16,3
330,3556,אלמוג,21,19,2
160,1309,אלעד,1007,1474,-467
190,3618,אלעזר,75,178,-103
180,3750,אלפי מנשה,364,343,21
310,603,אלקוש,7,19,-12
190,3560,אלקנה,149,275,-126
310,772,אמונים,37,43,-6
310,1064,אמירים,48,43,5
310,1253,אמנון,17,25,-8
320,23,אמציה,7,165,-158
310,4012,אניעם,16,23,-7
370,3754,אספר,89,41,48
270,529,אעבלין,108,107,1
330,4301,אפיק,33,6,27
330,176,אפיקים,43,74,-31
330,313,אפק,60,8,52
170,3650,אפרת,1110,432,678
310,701,ארבל,27,32,-5
310,3598,ארגמן,7,7,0
330,714,ארז,37,20,17
160,3570,אריאל,661,776,-115
350,1324,ארסוף,16,21,-5
310,71,אשבול,71,5,66
330,1276,אשבל,12,2,10
130,70,אשדוד,3427,6253,-2826
330,199,אשדות יעקב (איחוד),32,40,-8
330,188,אשדות יעקב (מאוחד),51,25,26
370,1188,אשחר,42,21,21
370,3722,אשכולות,95,50,45
340,2021,אשל הנשיא,12,5,7
370,1152,אשלים,73,61,12
140,7100,אשקלון,4156,3601,555
370,1256,אשרת,28,27,1
310,740,אשתאול,30,69,-39
260,6000,באקה אל-גרביה,220,217,3
370,21,באר אורה,135,38,97
370,1376,באר גנים,293,42,251
310,155,באר טוביה,76,37,39
160,2530,באר יעקב,3399,804,2595
310,1278,באר מילכה,9,0,9
130,9000,באר שבע,4326,6137,-1811
330,450,בארות יצחק,13,15,-2
310,697,בארותיים,40,39,1
330,399,בארי,27,26,1
310,559,בוסתן הגליל,93,48,45
280,482,בועיינה-נוג'ידאת,90,67,23
280,4001,בוקעאתא,25,24,1
310,698,בורגתה,58,66,-8
330,2043,בחן,24,27,-3
310,762,בטחה,31,24,7
310,234,ביצרון,53,33,20
280,998,ביר אל-מכסור,61,64,-3
280,1348,ביר הדאג',376,4,372
350,368,בירייה,83,86,-3
330,317,בית אורן,23,22,1
180,3574,בית אל,157,434,-277
310,562,בית אלעזרי,62,68,-6
330,95,בית אלפא,13,45,-32
180,3652,בית אריה,292,181,111
340,1076,בית ברל,5,17,-12
270,480,בית ג'ן,55,56,-1
330,619,בית גוברין,6,14,-8
310,571,בית גמליאל,44,32,12
180,466,בית דגן,248,307,-59
310,723,בית הגדי,80,35,45
310,373,בית הלוי,40,59,-19
310,322,בית הלל,32,45,-13
330,572,בית העמק,14,14,0
330,3645,בית הערבה,71,10,61
330,242,בית השיטה,45,44,1
350,353,בית זיד,1,4,-3
310,710,בית זית,68,96,-28
330,143,בית זרע,64,42,22
370,3575,בית חורון,83,58,25
320,877,בית חירות,56,50,6
310,2033,בית חלקיה,27,35,-8
310,159,בית חנן,31,62,-31
310,800,בית חנניה,31,33,-2
190,1050,בית חשמונאי,75,93,-18
310,288,בית יהושע,49,80,-31
310,265,בית יוסף,25,7,18
310,200,בית ינאי,13,35,-22
191,326,בית יצחק-שער חפר,77,124,-47
310,430,בית לחם הגלילית,47,19,28
310,751,בית מאיר,62,72,-10
310,784,בית נחמיה,21,47,-26
330,16,בית ניר,20,8,12
310,672,בית נקופה,103,55,48
310,202,בית עובד,9,34,-25
310,301,בית עוזיאל,42,32,10
310,756,בית עזרא,56,50,6
310,604,בית עריף,40,21,19
340,212,בית צבי,15,24,-9
330,598,בית קמה,18,21,-3
330,365,בית קשת,68,12,56
340,848,בית רבן,77,131,-54
330,1162,בית רימון,104,17,87
170,9200,בית שאן,606,418,188
140,2610,בית שמש,3518,2963,555
310,248,בית שערים,28,36,-8
310,747,בית שקמה,28,42,-14
310,252,ביתן אהרן,42,15,27
150,3780,ביתר עילית,1449,1610,-161
310,94,בלפוריה,56,42,14
310,760,בן זכאי,59,38,21
310,712,בן עמי,45,52,-7
340,1084,בן שמן (כפר נוער),17,13,4
310,2013,בן שמן (מושב),45,51,-6
140,6100,בני ברק,3412,6523,-3111
370,1368,בני דקלים,129,15,114
320,592,בני דרום,68,17,51
320,386,בני דרור,55,54,1
370,4015,בני יהודה,54,54,0
310,1363,בני נצרים,44,36,8
310,448,בני עטרות,35,38,-3
180,1066,"בני עי""ש",195,286,-91
310,418,בני ציון,26,93,-67
310,588,בני ראם,48,68,-20
310,685,בניה,26,35,-9
170,9800,בנימינה-גבעת עדה*,579,595,-16
280,1326,"בסמ""ה",93,78,15
280,944,בסמת טבעון,79,111,-32
280,483,בענה,106,107,-1
310,389,בצרה,55,41,14
310,589,בצת,26,13,13
310,864,בקוע,21,20,1
310,3612,בקעות,0,13,-13
310,823,בר גיורא,18,39,-21
370,1191,בר יוחאי,88,63,25
370,3744,ברוכין,135,13,122
330,428,ברור חיל,48,32,16
310,2060,ברוש,54,12,42
190,3710,ברכה,166,102,64
310,746,ברכיה,66,36,30
330,667,ברעם,4,10,-6
310,141,ברק,23,33,-10
330,617,ברקאי,8,21,-13
370,3654,ברקן,74,92,-18
191,2038,ברקת,90,62,28
350,1323,בת הדר,32,41,-9
350,1361,בת חן,27,35,-8
180,1319,בת חפר,101,205,-104
140,6200,בת ים,4003,6172,-2169
370,3794,בת עין,81,96,-15
310,33,בת שלמה,32,35,-3
260,1292,ג'דיידה-מכר,232,225,7
280,485,ג'ולס,45,37,8
280,627,ג'לג'וליה,58,122,-64
270,541,ג'סר א-זרקא,58,148,-90
290,487,ג'ש (גוש חלב),37,45,-8
270,628,ג'ת,152,107,45
310,872,גאולי תימן,7,9,-2
310,379,גאולים,54,44,10
310,853,גאליה,37,48,-11
330,352,גבולות,16,24,-8
330,424,גבים,40,23,17
330,86,גבע,10,25,-15
180,3763,גבע בנימין,253,266,-13
310,683,גבע כרמל,47,74,-27
310,2014,גבעולים,41,6,35
370,3644,גבעון החדשה,36,119,-83
370,1344,גבעות בר,138,28,110
370,1293,גבעת אבני,66,95,-29
370,1288,גבעת אלה,61,65,-4
193,147,גבעת ברנר,42,41,1
330,870,גבעת השלושה,42,18,24
170,3730,גבעת זאב,1137,1003,134
310,207,"גבעת ח""ן",17,11,6
330,2018,גבעת חיים (איחוד),57,25,32
330,173,גבעת חיים (מאוחד),24,21,3
310,4021,גבעת יואב,20,16,4
310,787,גבעת יערים,49,54,-5
310,919,גבעת ישעיהו,25,52,-27
310,802,"גבעת כ""ח",40,41,-1
310,360,"גבעת ניל""י",14,56,-42
330,703,גבעת עוז,4,16,-12
160,681,גבעת שמואל,1212,1339,-127
340,566,גבעת שמש,1,1,0
310,1077,גבעת שפירא,9,22,-13
310,793,גבעתי,29,24,5
150,6300,גבעתיים,4070,4033,37
330,342,גברעם,13,8,5
330,133,גבת,31,22,9
330,35,גדות,25,10,15
310,145,גדיש,8,10,-2
350,442,גדעונה,24,15,9
160,2550,גדרה,895,797,98
330,852,גונן,29,24,5
310,755,גורן,20,15,5
350,1219,גורנות הגליל,11,8,3
330,457,גזית,43,13,30
330,370,גזר,22,8,14
310,706,גיאה,27,34,-7
350,196,גיבתון,29,17,12
350,1043,גיזו,10,14,-4
370,1204,גילון,35,48,-13
310,736,גילת,66,61,5
330,262,גינוסר,29,20,9
330,92,גיניגר,23,29,-6
310,863,גינתון,37,63,-26
370,1206,גיתה,6,9,-3
310,3613,גיתית,42,10,32
330,393,גלאון,67,15,52
330,3606,גלגל,6,13,-7
330,346,גליל ים,6,8,-2
330,369,גלעד (אבן יצחק),8,6,2
310,745,גמזו,40,46,-6
310,1072,גן הדרום,28,16,12
310,225,גן השומרון,34,21,13
310,239,גן חיים,52,42,10
310,734,גן יאשיה,31,20,11
160,166,גן יבנה,778,737,41
190,1274,גן נר,81,105,-24
310,311,גן שורק,14,27,-13
330,144,גן שלמה,12,5,7
330,72,גן שמואל,10,17,-7
310,836,גנות,8,41,-33
350,549,גנות הדר,39,38,1
350,1103,גני הדר,26,8,18
370,1371,גני טל,34,42,-8
310,862,גני יוחנן,52,48,4
190,3823,גני מודיעין,288,287,1
350,218,גני עם,12,17,-5
170,229,גני תקווה,1236,613,623
330,842,געש,44,18,26
330,463,געתון,66,8,58
310,39,גפן,7,30,-23
330,1129,גרופית,15,21,-6
330,4022,גשור,12,8,4
330,305,גשר,24,30,-6
330,574,גשר הזיו,49,75,-26
350,128,גת רימון,16,4,12
270,494,דאלית אל-כרמל,178,168,10
310,146,דבורה,34,14,20
270,489,דבורייה,150,78,72
330,849,דבירה,95,25,70
330,407,דברת,31,24,7
330,62,דגניה א',9,19,-10
330,79,דגניה ב',16,13,3
310,1067,"דוב""ב",16,16,0
370,3747,דולב,61,102,-41
310,738,דור,32,23,9
330,336,דורות,32,31,1
450,475,דחי,21,4,17
270,490,דייר אל-אסד,110,115,-5
270,492,דייר חנא,104,80,24
440,493,דייר ראפאת,3,0,3
160,2200,דימונה,976,826,150
310,2063,דישון,4,16,-12
330,300,דלייה,19,24,-5
310,431,דלתון,23,21,2
450,1317,דמיידה,10,1,9
330,303,דן,30,31,-1
330,302,דפנה,24,44,-20
310,1241,דקל,13,14,-1
450,1349,דריג'את,43,23,20
330,702,האון,2,6,-4
320,675,הבונים,13,21,-8
330,356,הגושרים,45,44,1
310,191,הדר עם,45,28,17
150,9700,הוד השרון,2726,2105,621
340,1322,הודיות,0,4,-4
310,726,הודייה,61,25,36
190,1186,הושעיה,66,78,-12
330,250,הזורע,20,18,2
310,307,הזורעים,45,48,-3
330,434,החותרים,28,20,8
310,684,היוגב,36,15,21
370,1208,הילה,24,14,10
330,377,המעפיל,29,16,13
330,677,הסוללים,25,51,-26
330,423,העוגן,19,12,7
190,3769,הר אדר,146,179,-33
370,3603,הר גילה,61,74,-13
330,1261,הר עמשא,18,7,11
330,464,הראל,9,12,-3
330,1249,הרדוף,15,21,-6
150,6400,הרצלייה,3832,3833,-1
370,1203,הררית,59,14,45
310,3639,ורד יריחו,35,17,18
350,1133,ורדון,12,22,-10
310,815,זבדיאל,26,22,4
310,44,זוהר,9,17,-8
330,584,זיקים,86,23,63
310,788,זיתן,42,59,-17
160,9300,זכרון יעקב,895,872,23
310,799,זכריה,44,38,6
280,1290,זמר,107,72,35
310,1065,זמרת,37,26,11
310,816,זנוח,45,36,9
310,2064,זרועה,32,23,9
280,975,זרזיר,64,81,-17
310,818,זרחיה,10,20,-10
450,1321,ח'ואלד,186,2,184
310,235,חבצלת השרון,20,12,8
350,1110,חבר,66,19,47
310,717,חגור,35,53,-18
370,3764,חגי,67,41,26
310,205,חגלה,10,29,-19
370,4026,חד-נס,55,86,-31
310,618,חדיד,26,45,-19
150,6500,חדרה,3001,2605,396
330,160,חולדה,51,33,18
140,6600,חולון,5513,6080,-567
330,1239,חולית,10,10,0
330,253,חולתה,44,42,2
310,662,חוסן,65,35,30
450,1332,חוסנייה,33,5,28
350,115,חופית,37,41,-4
330,374,חוקוק,17,54,-37
260,1303,חורה,348,247,101
280,496,חורפיש,45,54,-9
330,355,חורשים,21,12,9
310,1047,חזון,8,15,-7
310,219,חיבת ציון,62,31,31
370,3643,חיננית,72,101,-29
130,4000,חיפה,7862,9896,-2034
310,162,חירות,55,45,10
370,1272,חלוץ,36,27,9
310,820,חלץ,5,18,-13
450,993,חמאם,17,36,-19
310,801,חמד,50,59,-9
330,343,חמדיה,17,28,-11
370,3646,חמדת,25,4,21
310,3609,חמרה,10,7,3
310,807,חניאל,31,69,-38
330,280,חניתה,44,39,5
330,1257,חנתון,36,23,13
190,4005,חספין,91,94,-3
330,363,חפץ חיים,33,21,12
330,90,חפצי-בה,70,29,41
310,700,חצב,38,57,-19
310,13,חצבה,42,27,15
330,406,חצור-אשדוד,23,14,9
180,2034,חצור הגלילית,264,349,-85
330,397,חצרים,21,16,5
310,422,חרב לאת,35,39,-4
350,1024,חרוצים,20,60,-40
180,1247,חריש,3916,129,3787
370,3717,חרמש,23,15,8
370,1209,חרשים,20,16,4
190,3770,חשמונאים,129,304,-175
160,6700,טבריה,1574,1576,-2
280,962,טובא-זנגרייה,47,62,-15
270,498,טורעאן,140,103,37
260,2730,טייבה,256,233,23
450,497,טייבה (בעמק),10,19,-9
260,2720,טירה,184,113,71
310,663,טירת יהודה,40,54,-14
160,2100,טירת כרמל,1142,537,605
330,268,טירת צבי,21,35,-14
370,1181,טל-אל,59,35,24
310,462,טל שחר,49,57,-8
330,1177,טללים,60,12,48
190,3788,טלמון,278,128,150
260,8900,טמרה,161,178,-17
450,547,טמרה (יזרעאל),6,14,-8
370,3743,טנא,71,38,33
310,1214,טפחות,12,20,-8
280,1295,יאנוח-ג'ת,102,46,56
310,1232,יבול,3,13,-10
190,46,יבנאל,110,142,-32
160,2660,יבנה,1683,1424,259
330,96,יגור,38,77,-39
310,798,יגל,18,46,-28
190,577,יד בנימין,221,260,-39
320,1134,יד השמונה,30,17,13
330,758,יד חנה,39,35,4
330,358,יד מרדכי,24,25,-1
310,775,יד נתן,39,21,18
310,64,"יד רמב""ם",62,73,-11
160,9400,יהוד,988,1079,-91
330,1158,יהל,14,39,-25
310,2009,יובל,18,19,-1
370,1226,יובלים,52,83,-31
320,1112,יודפת,61,31,30
320,4007,יונתן,29,26,3
310,803,יושיביה,78,32,46
330,452,יזרעאל,2,18,-16
330,409,יחיעם,91,45,46
330,866,יטבתה,38,28,10
320,3607,"ייט""ב",32,33,-1
310,811,יכיני,46,30,16
310,753,ינוב,31,44,-13
310,2011,ינון,55,40,15
350,29,יסוד המעלה,112,100,12
320,440,יסודות,9,29,-20
330,575,יסעור,23,9,14
310,1138,יעד,6,18,-12
350,1044,יעף,20,24,-4
310,795,יערה,20,23,-3
270,499,יפיע,218,266,-48
310,3566,יפית,28,3,25
330,134,יפעת,38,25,13
330,453,יפתח,24,23,1
370,3749,יצהר,66,67,-1
310,759,יציץ,38,39,-1
330,417,יקום,15,7,8
190,3647,יקיר,141,71,70
310,241,יקנעם (מושבה),79,75,4
160,240,יקנעם עילית,852,607,245
330,623,יראון,18,17,1
310,2026,ירדנה,12,11,1
180,831,ירוחם,493,323,170
120,3000,ירושלים,12761,18809,-6048
310,718,ירחיב,75,20,55
270,502,ירכא,108,74,34
310,183,ירקונה,32,32,0
310,916,ישע,29,16,13
310,805,ישעי,40,56,-16
310,828,ישרש,46,66,-20
310,1227,יתד,53,28,25
270,504,כאבול,115,91,24
290,505,כאוכב אבו אל-היג'א,49,36,13
330,576,כברי,28,33,-5
340,371,כדורי,11,15,-4
370,1338,כדיתה,17,9,8
190,3564,כוכב השחר,125,120,5
180,1224,כוכב יאיר,330,477,-147
180,3779,כוכב יעקב,541,335,206
310,824,כוכב מיכאל,51,35,16
350,1252,כורזים,18,19,-1
310,1210,כחל,27,21,6
450,1367,כחלה,206,6,200
330,840,כיסופים,34,17,17
330,1153,כישור,2,3,-1
370,1183,כליל,46,46,0
310,1229,כלנית,9,8,1
450,1331,כמאנה,36,19,17
310,1291,כמהין,4,5,-1
370,1201,כמון,56,37,19
340,2006,כנות,6,1,5
310,4028,כנף,9,12,-3
350,63,כנרת (מושבה),50,48,2
330,57,כנרת (קבוצה),15,12,3
260,1059,כסיפה,472,230,242
310,859,כסלון,29,27,2
280,1296,כסרא-סמיע,46,61,-15
280,978,כעביה-טבאש-חג'אג'רה,159,53,106
310,857,כפר אביב,31,32,-1
190,3638,כפר אדומים,183,128,55
310,364,כפר אוריה,20,44,-24
310,690,כפר אחים,36,34,2
310,220,כפר ביאליק,70,27,43
310,177,"כפר ביל""ו",54,90,-36
330,357,כפר בלום,49,22,27
310,2010,כפר בן נון,39,34,5
290,633,כפר ברא,71,51,20
310,132,כפר ברוך,26,20,6
310,106,כפר גדעון,14,25,-11
340,427,כפר גלים,10,44,-34
330,310,כפר גליקסון,32,7,25
330,76,כפר גלעדי,24,21,3
320,707,כפר דניאל,15,35,-20
190,3796,כפר האורנים,62,78,-16
330,192,כפר החורש,45,20,25
330,254,כפר המכבי,22,15,7
310,582,כפר הנגיד,45,40,5
340,890,כפר הנוער הדתי,5,12,-7
330,443,כפר הנשיא,37,18,19
310,187,כפר הס,46,62,-16
310,217,"כפר הרא""ה",44,93,-49
310,888,"כפר הרי""ף",27,35,-8
191,190,כפר ויתקין,94,105,-11
310,320,כפר ורבורג,40,43,-3
180,1263,כפר ורדים,313,292,21
340,1325,כפר זוהרים,19,12,7
310,786,כפר זיתים,25,30,-5
180,696,"כפר חב""ד",116,264,-148
310,609,כפר חושן,40,17,23
320,255,כפר חיטים,9,35,-26
310,193,כפר חיים,11,28,-17
370,1297,כפר חנניה,32,49,-17
310,112,כפר חסידים א',51,86,-35
350,889,כפר חסידים ב',60,594,-534
330,4004,כפר חרוב,22,14,8
310,673,כפר טרומן,62,47,15
270,507,כפר יאסיף,191,145,46
310,233,כפר ידידיה,18,29,-11
310,140,כפר יהושע,56,42,14
160,168,כפר יונה,1149,930,219
310,85,כפר יחזקאל,42,45,-3
310,170,כפר יעבץ,18,49,-31
290,508,כפר כמא,28,8,20
260,509,כפר כנא,220,216,4
310,387,כפר מונש,38,34,4
310,1095,כפר מימון,11,29,-18
310,98,"כפר מל""ל",29,22,7
270,510,כפר מנדא,164,93,71
330,297,כפר מסריק,34,20,14
290,512,כפר מצר,11,15,-4
310,764,כפר מרדכי,29,33,-4
310,316,כפר נטר,56,85,-29
330,345,כפר סאלד,40,33,7
140,6900,כפר סבא,3531,3507,24
340,107,כפר סילבר,20,30,-10
310,249,כפר סירקין,94,57,37
330,845,כפר עזה,32,54,-22
330,3488,כפר עציון,38,29,9
310,189,כפר פינס,51,44,7
260,634,כפר קאסם,148,114,34
310,388,כפר קיש,33,23,10
270,654,כפר קרע,232,174,58
330,579,כפר ראש הנקרה,45,45,0
310,1130,כפר רוזנואלד (זרעית),4,6,-2
330,295,כפר רופין,25,30,-5
310,1166,כפר רות,25,13,12
310,605,כפר שמאי,66,40,26
310,743,כפר שמואל,59,33,26
350,267,כפר שמריהו,143,100,43
190,47,כפר תבור,280,149,131
370,3572,כפר תפוח,96,49,47
370,1285,כרכום,20,25,-5
310,664,כרם בן זמרה,26,24,2
350,88,כרם בן שמן,1,1,0
340,1094,כרם יבנה (ישיבה),33,68,-35
310,580,"כרם מהר""ל",37,39,-2
330,1085,כרם שלום,51,5,46
350,1264,כרמי יוסף,105,102,3
370,3766,כרמי צור,17,58,-41
370,1374,כרמי קטיף,226,1,225
160,1139,כרמיאל,1086,1785,-699
330,768,כרמייה,26,34,-8
330,1198,כרמים,26,18,8
320,3656,כרמל,21,31,-10
350,1207,לבון,39,28,11
330,585,לביא,14,22,-8
310,1230,לבנים,11,14,-3
330,2023,להב,23,32,-9
330,380,להבות הבשן,30,47,-17
330,715,להבות חביבה,99,14,85
180,1271,להבים,212,298,-86
150,7000,לוד,2184,2457,-273
310,52,לוזית,50,29,21
330,595,לוחמי הגיטאות,20,10,10
330,1171,לוטם,40,20,20
330,1255,לוטן,8,25,-17
310,674,לימן,49,86,-37
310,24,לכיש,30,15,15
190,1310,לפיד,76,120,-44
310,1173,לפידות,3,10,-7
270,1060,לקיה,176,134,42
310,2055,מאור,102,59,43
340,102,מאיר שפיה,5,29,-24
320,771,מבוא ביתר,31,35,-4
370,3569,מבוא דותן,33,38,-5
192,3709,מבוא חורון,91,120,-29
330,4204,מבוא חמה,33,8,25
370,1141,מבוא מודיעים,19,19,0
340,1318,מבואות ים,9,10,-1
350,1080,מבועים,43,59,-16
310,829,מבטחים,17,24,-7
310,573,מבקיעים,47,17,30
160,1015,מבשרת ציון,889,1309,-420
270,516,מג'ד אל-כרום,84,89,-5
270,4201,מג'דל שמס,68,64,4
260,481,מגאר,132,177,-45
310,689,מגדים,59,56,3
350,65,מגדל,99,85,14
160,874,מגדל העמק,577,1069,-492
330,3561,מגדל עוז,15,76,-61
370,3751,מגדלים,50,39,11
330,586,מגידו,24,16,8
330,375,מגל,44,11,33
330,695,מגן,3,24,-21
310,1155,מגן שאול,24,42,-18
310,722,מגשימים,31,63,-32
310,2029,מדרך עוז,37,31,6
350,1140,מדרשת בן גוריון,66,102,-36
150,1200,מודיעין-מכבים-רעות*,2631,2625,6
150,3797,מודיעין עילית,1425,1605,-180
320,269,מולדת,38,28,10
350,208,מוצא עילית,115,59,56
290,635,מוקייבלה,62,28,34
330,1163,מורן,19,21,-2
370,1178,מורשת,44,50,-6
310,606,מזור,57,55,2
170,28,מזכרת בתיה,776,478,298
330,104,מזרע,36,17,19
290,517,מזרעה,60,43,17
310,3599,מחולה,33,18,15
350,1196,מחנה יתיר,10,2,8
330,308,מחניים,44,17,27
310,776,מחסיה,16,21,-5
350,43,מטולה,115,140,-25
310,822,מטע,51,41,10
320,1128,מי עמי,15,11,4
310,2054,מיטב,22,30,-8
450,649,מייסר,20,32,-12
310,4019,מיצר,15,8,7
330,1282,מירב,30,10,20
310,607,מירון,52,59,-7
310,731,מישר,23,29,-6
180,1268,מיתר,971,347,624
310,3614,מכורה,20,1,19
450,1343,מכחול,228,8,220
310,382,מכמורת,61,69,-8
370,1202,מכמנים,29,15,14
310,164,מלאה,11,26,-15
310,2044,מלילות,31,21,10
330,596,מלכייה,17,17,0
340,1154,מלכישוע,0,2,-2
310,2030,מנוחה,41,12,29
310,1174,מנוף,32,19,13
310,1205,מנות,32,23,9
350,48,מנחמיה,38,57,-19
330,347,מנרה,15,17,-2
450,994,מנשית זבדה,16,22,-6
370,1258,מסד,17,23,-6
330,263,מסדה,32,43,-11
330,298,מסילות,19,30,-11
310,742,מסילת ציון,28,62,-34
310,748,מסלול,55,33,22
290,4203,מסעדה,32,37,-5
330,197,מעברות,5,18,-13
190,1082,מעגלים,62,65,-3
330,678,מעגן,11,22,-11
330,694,מעגן מיכאל,25,68,-43
330,272,מעוז חיים,14,31,-17
320,3657,מעון,29,28,1
310,570,מעונה,41,45,-4
330,416,מעיין ברוך,52,44,8
330,290,מעיין צבי,39,21,18
290,518,מעיליא,38,38,0
160,3616,מעלה אדומים,1081,1545,-464
350,3608,מעלה אפרים,44,101,-57
330,1127,מעלה גלבוע,39,23,16
310,4008,מעלה גמלא,28,16,12
330,286,מעלה החמישה,35,19,16
370,3752,מעלה לבונה,38,32,6
370,3651,מעלה מכמש,54,59,-5
270,1327,מעלה עירון,111,120,-9
370,3653,מעלה עמוס,95,10,85
370,3637,מעלה שומרון,35,83,-48
160,1063,מעלות-תרשיחא,659,750,-91
330,344,מענית,38,3,35
310,230,מעש,44,41,3
330,668,מפלסים,34,45,-11
320,3745,מצדות יהודה,25,33,-8
330,325,מצובה,47,53,-6
310,757,מצליח,42,65,-23
350,58,מצפה,6,9,-3
370,1222,"מצפה אבי""ב",48,28,20
370,1370,מצפה אילן,59,1,58
190,3576,מצפה יריחו,57,121,-64
370,1190,מצפה נטופה,43,36,7
180,99,מצפה רמון,298,471,-173
330,3610,מצפה שלם,13,6,7
330,648,מצר,21,39,-18
340,22,מקווה ישראל,18,24,-6
310,843,מרגליות,14,14,0
330,4101,מרום גולן,33,13,20
370,1340,מרחב עם,23,19,4
310,97,מרחביה (מושב),20,39,-19
330,66,מרחביה (קיבוץ),12,104,-92
190,1098,מרכז שפירא,79,110,-31
330,421,משאבי שדה,16,45,-29
310,765,משגב דב,50,34,16
330,378,משגב עם,23,24,-1
280,520,משהד,108,112,-4
310,3605,משואה,18,3,15
320,620,משואות יצחק,26,29,-3
370,3785,משכיות,17,13,4
310,670,משמר איילון,21,41,-20
330,563,משמר דוד,63,21,42
310,732,משמר הירדן,69,47,22
330,395,משמר הנגב,59,29,30
330,130,משמר העמק,9,31,-22
310,729,משמר השבעה,61,54,7
330,194,משמר השרון,20,10,10
330,213,משמרות,106,19,87
310,425,משמרת,44,42,2
310,791,משען,39,58,-19
190,1315,מתן,135,147,-12
370,1184,מתת,4,9,-5
320,3648,מתתיהו,76,52,24
310,4551,נאות גולן,38,21,17
310,1124,נאות הכיכר,10,5,5
330,408,נאות מרדכי,34,40,-6
330,1197,נאות סמדר,9,18,-9
290,524,נאעורה,21,33,-12
330,315,נגבה,12,7,5
370,3724,נגוהות,22,10,12
350,309,נהורה,54,74,-20
310,80,נהלל,56,35,21
150,9100,נהרייה,1909,2071,-162
310,4304,נוב,22,17,5
310,55,נוגה,20,19,1
370,3573,נוה צוף,10,42,-32
310,1366,נווה,41,31,10
330,590,נווה אור,21,23,-2
310,4303,"נווה אטי""ב",5,14,-9
320,405,נווה אילן,55,43,12
330,296,נווה איתן,13,21,-8
190,3725,נווה דניאל,61,178,-117
350,1057,נווה זוהר,2,5,-3
370,1314,נווה זיו,50,42,8
330,1279,נווה חריף,8,7,1
330,312,נווה ים,5,11,-6
310,686,נווה ימין,88,88,0
310,858,נווה ירק,42,80,-38
310,827,נווה מבטח,26,21,5
310,1071,נווה מיכאל,80,38,42
350,1259,נווה שלום,14,9,5
310,15,נועם,16,31,-15
190,1333,נוף איילון,68,172,-104
350,3790,נופים,114,41,73
190,1284,נופית,89,128,-39
370,257,נופך,39,5,34
190,3726,נוקדים,124,101,23
320,447,נורדייה,52,80,-28
370,833,נורית,32,1,31
310,59,נחושה,51,46,5
330,844,נחל עוז,25,27,-2
310,2045,נחלה,47,27,20
370,3767,נחליאל,39,40,-1
310,449,נחלים,70,113,-43
310,809,נחם,22,17,5
270,522,נחף,53,82,-29
330,433,נחשולים,15,12,3
330,777,נחשון,28,4,24
330,705,נחשונים,18,4,14
310,1147,נטועה,7,7,0
310,4014,נטור,35,8,27
370,1369,נטע,47,14,33
310,174,נטעים,36,29,7
370,1254,נטף,27,28,-1
450,523,ניין,24,20,4
370,3655,"ניל""י",180,90,90
190,351,ניצן,222,84,138
350,1419,ניצן ב',10,242,-232
340,1195,ניצנה (קהילת חינוך),23,70,-47
310,1280,ניצני סיני,10,6,4
310,851,ניצני עוז,22,30,-8
330,359,ניצנים,19,25,-6
330,808,ניר אליהו,26,9,17
310,553,ניר בנים,24,29,-5
320,720,ניר גלים,55,73,-18
330,256,ניר דוד (תל עמל),7,10,-3
310,11,"ניר ח""ן",30,42,-12
310,165,ניר יפה,26,8,18
330,402,ניר יצחק,32,21,11
310,699,ניר ישראל,52,45,7
310,2047,ניר משה,27,31,-4
330,69,ניר עוז,18,19,-1
330,348,ניר עם,43,34,9
310,2048,ניר עקיבא,38,178,-140
310,331,ניר צבי,62,41,21
330,602,נירים,13,20,-7
370,1236,נירית,42,123,-81
310,825,נס הרים,54,55,-1
350,1143,נס עמים,52,27,25
150,7200,נס ציונה,1444,1264,180
340,186,נעורים,26,40,-14
350,3787,נעלה,166,47,119
310,3713,"נעמ""ה",15,5,10
330,158,נען,37,40,-3
330,3620,נערן,0,2,-2
310,1372,נצר חזני,35,11,24
330,435,נצר סרני,32,2,30
250,7300,נצרת,665,1265,-600
160,1061,נצרת עילית,1566,1642,-76
160,2500,נשר,1088,1151,-63
310,3555,נתיב הגדוד,14,14,0
330,693,"נתיב הל""ה",23,15,8
310,1242,נתיב העשרה,33,35,-2
310,792,נתיב השיירה,26,22,4
160,246,נתיבות,1778,1110,668
130,7400,נתניה,5117,6085,-968
290,525,סאג'ור,57,44,13
330,578,סאסא,3,17,-14
190,587,סביון*,244,185,59
310,2046,סגולה,22,27,-5
450,942,סואעד (חמרייה)*,11,3,8
290,526,סולם,37,51,-14
370,3756,סוסיה,111,46,65
330,1238,סופה,15,11,4
260,7500,סח'נין,213,207,6
290,1245,סלמה,55,71,-16
310,3567,סלעית,189,21,168
330,1156,סמר,9,8,1
370,3777,סנסנה,54,6,48
330,419,סעד,60,28,32
450,1360,סעוה,1289,0,1289
330,454,סער,27,29,-2
350,1176,ספיר,44,37,7
310,610,סתרייה,58,62,-4
290,4501,ע'ג'ר,2,1,1
310,892,עבדון,30,25,5
330,376,עברון,26,9,17
310,794,עגור,15,19,-4
370,1199,עדי,38,65,-27
310,2035,עדנים,19,31,-12
310,826,עוזה,18,21,-3
290,528,עוזייר,28,38,-10
310,737,עולש,69,59,10
180,666,עומר,343,382,-39
310,810,עופר,28,35,-7
310,32,עוצם,20,19,1
370,328,עזוז,1,0,1
350,1149,עזר,23,38,-15
310,837,עזריאל,26,30,-4
310,711,עזריה,50,66,-16
310,817,עזריקם,58,75,-17
370,3658,עטרת,11,17,-6
310,1175,עידן,22,22,0
280,530,עיילבון,80,95,-15
340,156,עיינות,10,111,-101
280,511,עילוט,116,53,63
310,687,עין איילה,69,63,6
450,546,עין אל-אסד,5,9,-4
330,273,עין גב,22,13,9
330,2042,עין גדי,46,34,12
330,436,עין דור,43,63,-20
310,1240,עין הבשור,19,50,-31
370,74,עין הוד,32,25,7
330,167,עין החורש,39,13,26
330,289,עין המפרץ,16,17,-1
330,383,"עין הנצי""ב",42,35,7
350,367,עין העמק,21,28,-7
330,270,עין השופט,22,79,-57
330,676,עין השלושה,6,60,-54
310,157,עין ורד,69,49,20
330,4503,עין זיוון,34,18,16
450,1320,עין חוד,40,92,-52
330,89,עין חרוד (איחוד),16,4,12
330,82,עין חרוד (מאוחד),11,22,-11
310,806,עין יהב,29,20,9
310,813,עין יעקב,61,43,18
340,1056,"עין כרם-בי""ס חקלאי",0,3,-3
330,426,עין כרמל,17,23,-6
270,532,עין מאהל,94,78,16
290,521,עין נקובא,38,12,26
310,223,עין עירון,26,41,-15
330,622,עין צורים,44,85,-41
290,4502,עין קנייא,11,6,5
450,514,עין ראפה,19,16,3
330,139,עין שמר,21,42,-21
350,880,עין שריד,47,96,-49
310,1251,עין תמר,11,9,2
330,871,עינת,31,18,13
160,7600,עכו,935,1388,-453
330,1146,עלומים,12,35,-23
190,3765,עלי,261,311,-50
190,3727,עלי זהב,539,62,477
310,688,עלמה,26,24,2
370,3715,עלמון,42,83,-41
370,1212,עמוקה,5,11,-6
370,3824,עמיחי,211,0,211
310,779,עמינדב,42,86,-44
330,385,עמיעד,28,17,11
310,318,עמיעוז,9,24,-15
310,773,עמיקם,26,33,-7
330,319,עמיר,39,25,14
190,3660,עמנואל,333,222,111
310,708,עמקה,22,25,-3
370,3712,ענב,62,35,27
270,534,עספיא,253,211,42
150,7700,עפולה,2994,1499,1495
190,3617,עפרה,68,339,-271
190,3778,עץ אפרים,156,127,29
370,917,עצמון שגב,180,101,79
260,531,עראבה,133,170,-37
450,1246,עראמשה*,19,15,4
450,1335,ערב אל נעים,11,6,5
160,2560,ערד,1122,867,255
310,593,ערוגות,67,58,9
260,637,ערערה,217,179,38
270,1192,ערערה-בנגב,122,117,5
350,591,עשרת,46,41,5
180,53,עתלית,799,227,572
370,3748,עתניאל,50,39,11
310,1151,פארן,9,17,-8
370,3768,פדואל,114,45,69
310,750,פדויים,21,16,5
310,838,פדיה,21,29,-8
270,537,פוריידיס,66,82,-16
350,1104,פורייה - כפר עבודה,12,23,-11
350,1105,פורייה - נווה עובד,69,71,-2
350,1313,פורייה עילית,78,50,28
310,767,פורת,40,45,-5
310,749,פטיש,37,22,15
330,1185,פלך,6,0,6
330,597,פלמחים,29,35,-6
370,3723,פני חבר,38,22,16
370,3659,פסגות,93,115,-22
290,535,פסוטה,34,26,8
310,2059,"פעמי תש""ז",34,25,9
310,3615,פצאל,25,14,11
280,536,פקיעין (בוקייעה),49,31,18
310,281,פקיעין חדשה,54,72,-18
160,7800,פרדס חנה-כרכור,2197,1554,643
180,171,פרדסייה,234,309,-75
330,599,פרוד,32,15,17
310,2053,פרזון,19,25,-6
310,1231,פרי גן,6,10,-4
130,7900,פתח תקווה,8041,7905,136
310,839,פתחיה,26,50,-24
330,413,צאלים,5,24,-19
370,1180,צביה,10,5,5
330,1213,צבעון,84,10,74
330,465,צובה,9,32,-23
350,1136,צוחר,33,34,-1
190,3791,צופים,207,106,101
310,198,צופית,51,71,-20
310,1150,צופר,25,18,7
350,1102,צוקי ים,17,27,-10
370,1262,צוקים,20,8,12
180,1113,צור הדסה,1470,197,1273
180,1345,צור יצחק,658,280,378
190,276,צור משה,79,119,-40
320,1148,צור נתן,18,17,1
310,774,צוריאל,14,8,6
370,1221,צורית,88,54,34
310,613,ציפורי,16,34,-18
310,796,צלפון,68,31,37
450,636,צנדלה,15,21,-6
310,594,צפרייה,78,47,31
310,1079,צפרירים,41,30,11
160,8000,צפת,1366,1794,-428
310,612,צרופה,45,63,-18
330,567,צרעה,18,13,5
330,334,קבוצת יבנה,17,49,-32
190,3557,קדומים,160,223,-63
160,195,קדימה-צורן,868,762,106
310,4025,קדמת צבי,28,10,18
370,3781,קדר,62,111,-49
310,615,קדרון,55,56,-1
330,1211,קדרים,30,13,17
310,766,קוממיות,20,29,-9
370,1179,קורנית,28,25,3
330,1052,קטורה,28,52,-24
180,1167,קיסריה,363,311,52
310,414,קלחים,23,30,-7
330,3601,קליה,18,12,6
260,638,קלנסווה,158,220,-62
370,4024,קלע,30,9,21
190,1243,קציר,148,188,-40
290,1347,קצר א-סר,484,6,478
180,4100,קצרין,357,358,-1
160,2620,קריית אונו,1681,1609,72
180,3611,קריית ארבע,308,452,-144
150,6800,קריית אתא,1909,1859,50
160,9500,קריית ביאליק,1999,1950,49
150,2630,קריית גת,1822,1456,366
170,2300,קריית טבעון,725,692,33
160,9600,קריית ים,1464,2002,-538
180,1137,קריית יערים,539,194,345
160,8200,קריית מוצקין,2223,2063,160
160,1034,קריית מלאכי,1012,786,226
370,3746,קריית נטפים,26,39,-13
330,78,קריית ענבים,17,23,-6
170,469,קריית עקרון,343,481,-138
160,2800,קריית שמונה,507,926,-419
180,3640,קרני שומרון,515,366,149
320,4006,קשת,46,46,0
280,543,ראמה,101,111,-10
450,1334,ראס אל-עין,20,7,13
450,990,ראס עלי,18,5,13
150,2640,ראש העין,6156,1448,4708
190,26,ראש פינה,196,157,39
330,3602,ראש צורים,33,59,-26
130,8300,ראשון לציון,6673,8777,-2104
190,3795,רבבה,124,90,34
330,564,רבדים,45,19,26
330,354,רביבים,22,63,-41
330,1225,רביד,10,8,2
320,390,רגבה,29,35,-6
330,444,רגבים,18,18,0
250,1161,רהט,364,361,3
310,2051,רווחה,13,24,-11
310,2016,רוויה,8,9,-1
340,1341,רוח מדבר,0,1,-1
330,362,רוחמה,28,23,5
450,539,רומאנה,5,15,-10
450,997,רומת הייב,19,36,-17
310,3619,רועי,2,3,-1
310,854,רחוב,17,15,2
140,8400,רחובות,5211,4522,689
370,3822,רחלים,35,36,-1
450,540,ריחאנייה,2,17,-15
320,3568,ריחן,40,9,31
270,542,ריינה,224,325,-101
370,3565,רימונים,22,27,-5
310,616,רינתיה,51,58,-7
170,922,רכסים,326,520,-194
310,1069,רם-און,26,37,-11
310,4702,רמות,25,21,4
350,206,רמות השבים,113,100,13
310,735,רמות מאיר,18,26,-8
330,445,רמות מנשה,31,26,5
310,372,רמות נפתלי,14,25,-11
150,8500,רמלה,1547,2422,-875
140,8600,רמת גן,9293,8495,798
330,135,רמת דוד,21,52,-31
330,184,רמת הכובש,23,13,10
330,335,רמת השופט,32,38,-6
160,2650,רמת השרון,1987,1619,368
330,178,רמת יוחנן,17,19,-2
180,122,רמת ישי,266,323,-57
320,4701,רמת מגשימים,24,40,-16
310,339,רמת צבי,41,9,32
310,460,רמת רזיאל,35,29,6
330,127,רמת רחל,8,2,6
310,789,רנן,27,30,-3
330,713,רעים,3,11,-8
150,8700,רעננה,3153,3134,19
370,1228,רקפת,57,30,27
310,247,רשפון,69,87,-18
330,437,רשפים,79,18,61
320,1260,רתמים,7,20,-13
310,324,שאר ישוב,31,49,-18
310,1377,שבי דרום,141,0,141
320,282,שבי ציון,101,45,56
370,3571,שבי שומרון,35,55,-20
280,913,שבלי - אום אל-גנם,61,91,-30
270,1286,שגב-שלום,63,30,33
310,721,שדה אילן,26,20,6
330,304,שדה אליהו,42,47,-5
310,861,שדה אליעזר,38,61,-23
330,885,שדה בוקר,27,25,2
310,36,שדה דוד,53,21,32
310,284,שדה ורבורג,61,74,-13
330,293,שדה יואב,119,16,103
310,142,שדה יעקב,58,76,-18
310,2008,שדה יצחק,34,41,-7
310,18,שדה משה,32,38,-6
330,259,שדה נחום,39,15,24
330,329,שדה נחמיה,40,52,-12
310,1058,שדה ניצן,13,21,-8
310,739,שדה עוזיהו,32,49,-17
310,2049,שדה צבי,56,53,3
330,327,שדות ים,13,8,5
310,27,שדות מיכה,19,23,-4
310,1223,שדי אברהם,13,12,1
310,2015,שדי חמד,42,44,-2
310,2057,שדי תרומות,9,20,-11
310,555,שדמה,19,26,-7
310,306,שדמות דבורה,24,38,-14
320,3578,שדמות מחולה,46,29,17
160,1031,שדרות,1419,775,644
310,741,שואבה,52,29,23
310,761,שובה,51,41,10
330,394,שובל,47,14,33
160,1304,שוהם,630,699,-69
310,614,שומרה,6,12,-6
330,1265,שומרייה,56,11,45
310,415,שוקדה,55,22,33
320,456,שורש,73,74,-1
320,1235,שורשים,31,28,3
350,224,שושנת העמקים,19,33,-14
310,527,שזור,13,29,-16
310,7,שחר,53,33,20
370,1266,שחרות,4,3,1
310,865,שיבולים,20,39,-19
290,658,שייח' דנון,29,31,-2
190,3641,שילה,211,187,24
310,1165,שילת,34,31,3
370,1160,שכניה,47,35,12
310,873,שלווה,41,17,24
330,439,שלוחות,12,31,-19
180,812,שלומי,342,283,59
370,1364,שלומית,35,2,33
330,366,שמיר,10,9,1
370,3784,שמעה,78,32,46
330,432,שמרת,38,9,29
190,1337,שמשית,49,76,-27
370,1287,שני,29,31,-2
330,1132,שניר,24,15,9
280,538,שעב,60,50,10
310,4009,שעל,6,9,-3
330,856,שעלבים,65,36,29
310,661,שער אפרים,73,67,6
330,264,שער הגולן,13,10,3
330,237,שער העמקים,12,17,-5
340,921,שער מנשה,7,4,3
180,3720,שערי תקווה,242,263,-21
330,232,שפיים,9,15,-6
310,692,שפיר,25,41,-16
310,846,שפר,50,15,35
260,8800,שפרעם,315,351,-36
370,3649,שקד,61,53,8
310,1233,שקף,60,35,25
310,292,שרונה,14,26,-12
350,1114,שריגים (לי-און),55,62,-7
330,126,שריד,34,20,14
310,398,שרשרת,39,16,23
310,1045,שתולה,19,24,-5
191,763,שתולים,89,73,16
310,2062,תאשור,25,8,17
310,2061,תדהר,45,20,25
330,1172,תובל,16,11,5
310,3558,תומר,5,7,-2
350,1083,תושייה,30,26,4
320,163,תימורים,32,32,0
310,10,תירוש,17,29,-12
130,5000,תל אביב-יפו,21876,21294,582
330,84,תל יוסף,21,32,-11
330,287,תל יצחק,33,7,26
170,154,תל מונד,609,447,162
310,103,תל עדשים,68,68,0
330,719,תל קציר,36,18,18
260,1054,תל שבע,118,419,-301
370,1283,תל תאומים,21,8,13
320,3719,תלם,33,17,16
310,1051,תלמי אליהו,20,15,5
310,2003,תלמי אלעזר,62,37,25
310,2050,"תלמי ביל""ו",31,16,15
310,1237,תלמי יוסף,12,10,2
310,727,תלמי יחיאל,22,36,-14
320,744,תלמי יפה,19,14,5
310,814,תלמים,38,39,-1
370,1244,תמרת,62,60,2
310,2002,תנובות,27,32,-5
310,752,תעוז,26,16,10
191,709,תפרח,25,135,-110
310,665,תקומה,34,18,16
190,3563,תקוע,188,174,14
450,1346,תרבין א-צאנע (יישוב)*,504,0,504
310,778,תרום,27,16,11
