סמל צורת יישוב,סמל יישוב,שם יישוב,נכנסים,יוצאים,מאזן הגירה פנימית
280,472,אבו גוש,90,109,-19
270,473,אבו סנאן,195,164,31
450,1342,אבו קורינאת (יישוב),214,4,210
450,1375,אבו תלול,264,0,264
290,652,אבטין,33,29,4
370,1275,אבטליון,25,15,10
310,679,אביאל,76,62,14
310,1115,אביבים,9,22,-13
310,819,אביגדור,42,24,18
310,175,אביחיל,49,67,-18
310,2052,אביטל,31,20,11
310,1070,אביעזר,49,38,11
370,1220,אבירים,29,8,21
170,182,אבן יהודה,702,524,178
310,1081,אבן מנחם,18,16,2
310,783,אבן ספיר,17,35,-18
350,400,אבן שמואל,127,25,102
310,4011,אבני איתן,43,23,20
370,3793,אבני חפץ,80,56,24
370,3786,אבנת,16,8,8
370,1311,אבשלום,5,1,4
370,3759,אדורה,29,25,4
310,113,אדירים,10,9,1
310,1123,אדרת,21,18,3
310,446,אודים,108,65,43
320,4010,אודם,2,2,0
310,1046,אוהד,28,14,14
250,2710,אום אל-פחם,226,267,-41
450,2024,אום אל-קוטוף,16,14,2
290,1358,אום בטין,95,12,83
350,1108,אומן,17,21,-4
310,680,אומץ,28,22,6
160,31,אופקים,1162,807,355
320,1294,אור הגנוז,65,7,58
330,67,אור הנר,28,33,-5
160,2400,אור יהודה,933,1284,-351
170,1020,אור עקיבא,573,492,81
310,780,אורה,105,69,36
310,2012,אורות,31,42,-11
330,4013,אורטל,24,19,5
330,403,אורים,8,26,-18
180,3760,אורנית,368,335,33
330,278,אושה,22,9,13
170,565,אזור,636,531,105
350,1157,אחווה,14,1,13
310,821,אחוזם,29,16,13
190,1330,אחוזת ברק,97,85,12
310,785,אחיהוד,69,48,21
310,850,אחיטוב,14,34,-20
310,804,אחיסמך,60,55,5
310,797,אחיעזר,61,76,-15
340,338,איבים,54,56,-2
330,716,אייל,2,15,-13
330,77,איילת השחר,50,146,-96
330,294,אילון,49,56,-7
330,1126,אילות,25,43,-18
310,49,אילנייה,29,41,-12
150,2600,אילת,2845,3459,-614
370,1336,אירוס,154,2,152
370,3762,איתמר,66,74,-8
310,37,איתן,4,9,-5
270,478,אכסאל,91,96,-5
450,1339,אל -עזי,65,25,40
450,1316,אל -עריאן,5,2,3
330,4003,אל -רום,27,7,20
290,1359,אל סייד,276,1,275
350,1145,אלומה,5,28,-23
330,330,אלומות,33,6,27
310,1182,אלון הגליל,82,29,53
370,3579,אלון מורה,49,118,-69
190,3604,אלון שבות,111,289,-178
320,429,אלוני אבא,31,53,-22
320,4017,אלוני הבשן,30,5,25
340,868,אלוני יצחק,6,17,-11
330,285,אלונים,18,14,4
310,4002,אלי-עד,35,21,14
370,1365,אליאב,47,9,38
190,41,אליכין,113,164,-51
330,1248,אליפז,8,9,-1
310,730,אליפלט,52,8,44
310,682,אליקים,30,25,5
310,204,אלישיב,32,30,2
310,841,אלישמע,46,82,-36
310,1125,אלמגור,31,11,20
330,3556,אלמוג,32,8,24
160,1309,אלעד,979,1462,-483
190,3618,אלעזר,111,162,-51
180,3750,אלפי מנשה,478,381,97
310,603,אלקוש,13,24,-11
190,3560,אלקנה,135,229,-94
310,772,אמונים,32,47,-15
310,1064,אמירים,57,65,-8
310,1253,אמנון,20,17,3
320,23,אמציה,17,26,-9
310,4012,אניעם,49,44,5
370,3754,אספר,72,31,41
270,529,אעבלין,68,100,-32
330,4301,אפיק,28,26,2
330,176,אפיקים,59,86,-27
330,313,אפק,55,15,40
180,3650,אפרת,578,359,219
310,701,ארבל,49,21,28
310,3598,ארגמן,5,8,-3
330,714,ארז,12,17,-5
170,3570,אריאל,839,697,142
350,1324,ארסוף,15,10,5
310,71,אשבול,60,22,38
330,1276,אשבל,3,2,1
130,70,אשדוד,3463,6168,-2705
330,199,אשדות יעקב (איחוד),76,38,38
330,188,אשדות יעקב (מאוחד),71,46,25
370,1188,אשחר,85,14,71
370,3722,אשכולות,54,36,18
340,2021,אשל הנשיא,11,10,1
370,1152,אשלים,69,26,43
140,7100,אשקלון,4455,3096,1359
370,1256,אשרת,52,30,22
310,740,אשתאול,50,39,11
260,6000,באקה אל-גרביה,221,201,20
370,21,באר אורה,146,32,114
370,1376,באר גנים,289,13,276
310,155,באר טוביה,97,22,75
160,2530,באר יעקב,2045,785,1260
310,1278,באר מילכה,5,2,3
130,9000,באר שבע,4060,5423,-1363
330,450,בארות יצחק,13,19,-6
310,697,בארותיים,50,34,16
330,399,בארי,14,11,3
310,559,בוסתן הגליל,143,51,92
280,482,בועיינה-נוג'ידאת,51,54,-3
280,4001,בוקעאתא,32,19,13
310,698,בורגתה,53,63,-10
330,2043,בחן,67,20,47
310,762,בטחה,41,16,25
310,234,ביצרון,38,41,-3
280,998,ביר אל-מכסור,53,50,3
280,1348,ביר הדאג',510,20,490
350,368,בירייה,59,74,-15
330,317,בית אורן,17,2,15
180,3574,בית אל,173,391,-218
310,562,בית אלעזרי,52,51,1
330,95,בית אלפא,14,95,-81
190,3652,בית אריה,254,202,52
340,1076,בית ברל,11,11,0
270,480,בית ג'ן,48,66,-18
330,619,בית גוברין,9,12,-3
310,571,בית גמליאל,55,55,0
180,466,בית דגן,236,280,-44
310,723,בית הגדי,62,37,25
310,373,בית הלוי,16,41,-25
310,322,בית הלל,76,54,22
330,572,בית העמק,32,18,14
330,3645,בית הערבה,22,5,17
330,242,בית השיטה,82,89,-7
350,353,בית זיד,7,2,5
310,710,בית זית,77,100,-23
330,143,בית זרע,42,46,-4
370,3575,בית חורון,70,68,2
320,877,בית חירות,41,42,-1
310,2033,בית חלקיה,39,12,27
310,159,בית חנן,22,35,-13
310,800,בית חנניה,30,36,-6
190,1050,בית חשמונאי,76,72,4
310,288,בית יהושע,78,111,-33
310,265,בית יוסף,27,14,13
310,200,בית ינאי,15,41,-26
191,326,בית יצחק-שער חפר,105,128,-23
310,430,בית לחם הגלילית,49,41,8
310,751,בית מאיר,27,29,-2
310,784,בית נחמיה,37,53,-16
330,16,בית ניר,12,7,5
310,672,בית נקופה,70,63,7
310,202,בית עובד,24,31,-7
310,301,בית עוזיאל,48,21,27
310,756,בית עזרא,44,52,-8
310,604,בית עריף,53,45,8
340,212,בית צבי,2,30,-28
330,598,בית קמה,57,18,39
330,365,בית קשת,28,17,11
340,848,בית רבן,81,101,-20
330,1162,בית רימון,40,23,17
170,9200,בית שאן,371,468,-97
140,2610,בית שמש,4140,2352,1788
310,248,בית שערים,30,29,1
310,747,בית שקמה,32,20,12
310,252,ביתן אהרן,13,14,-1
150,3780,ביתר עילית,1590,1096,494
310,94,בלפוריה,40,29,11
310,760,בן זכאי,37,43,-6
310,712,בן עמי,70,61,9
340,1084,בן שמן (כפר נוער),11,16,-5
310,2013,בן שמן (מושב),55,72,-17
140,6100,בני ברק,3312,4881,-1569
370,1368,בני דקלים,127,23,104
320,592,בני דרום,32,13,19
320,386,בני דרור,61,55,6
370,4015,בני יהודה,66,93,-27
310,1363,בני נצרים,53,8,45
310,448,בני עטרות,39,54,-15
180,1066,"בני עי""ש",179,198,-19
310,418,בני ציון,78,73,5
310,588,בני ראם,30,58,-28
310,685,בניה,39,47,-8
170,9800,בנימינה-גבעת עדה*,734,529,205
280,1326,"בסמ""ה",111,68,43
280,944,בסמת טבעון,63,59,4
280,483,בענה,81,85,-4
310,389,בצרה,55,48,7
310,589,בצת,20,17,3
310,864,בקוע,35,25,10
310,3612,בקעות,5,8,-3
310,823,בר גיורא,43,38,5
370,1191,בר יוחאי,45,39,6
370,3744,ברוכין,44,4,40
330,428,ברור חיל,44,33,11
310,2060,ברוש,49,30,19
190,3710,ברכה,61,116,-55
310,746,ברכיה,29,45,-16
330,667,ברעם,2,5,-3
310,141,ברק,17,20,-3
330,617,ברקאי,31,7,24
370,3654,ברקן,112,89,23
310,2038,ברקת,76,52,24
350,1323,בת הדר,62,38,24
350,1361,בת חן,55,51,4
180,1319,בת חפר,172,253,-81
140,6200,בת ים,3852,5823,-1971
370,3794,בת עין,94,100,-6
310,33,בת שלמה,48,23,25
260,1292,ג'דיידה-מכר,257,262,-5
280,485,ג'ולס,31,23,8
280,627,ג'לג'וליה,80,78,2
270,541,ג'סר א-זרקא,47,107,-60
290,487,ג'ש (גוש חלב),26,39,-13
270,628,ג'ת,199,109,90
310,872,גאולי תימן,7,23,-16
310,379,גאולים,63,42,21
310,853,גאליה,30,50,-20
330,352,גבולות,30,14,16
330,424,גבים,67,13,54
330,86,גבע,12,16,-4
180,3763,גבע בנימין,271,299,-28
310,683,גבע כרמל,64,51,13
310,2014,גבעולים,17,8,9
370,3644,גבעון החדשה,71,104,-33
370,1344,גבעות בר,89,27,62
190,1293,גבעת אבני,57,101,-44
370,1288,גבעת אלה,118,87,31
193,147,גבעת ברנר,66,51,15
330,870,גבעת השלושה,26,39,-13
170,3730,גבעת זאב,1260,927,333
310,207,"גבעת ח""ן",15,22,-7
330,2018,גבעת חיים (איחוד),38,45,-7
330,173,גבעת חיים (מאוחד),14,19,-5
310,4021,גבעת יואב,35,15,20
310,787,גבעת יערים,109,63,46
310,919,גבעת ישעיהו,47,31,16
310,802,"גבעת כ""ח",44,33,11
310,360,"גבעת ניל""י",31,44,-13
330,703,גבעת עוז,7,7,0
160,681,גבעת שמואל,1075,1348,-273
310,1077,גבעת שפירא,8,27,-19
310,793,גבעתי,14,23,-9
150,6300,גבעתיים,3920,3683,237
330,342,גברעם,97,34,63
330,133,גבת,37,26,11
330,35,גדות,14,21,-7
310,145,גדיש,13,7,6
350,442,גדעונה,15,22,-7
160,2550,גדרה,1144,708,436
330,852,גונן,25,20,5
310,755,גורן,8,21,-13
350,1219,גורנות הגליל,16,13,3
330,457,גזית,42,25,17
330,370,גזר,5,0,5
310,706,גיאה,41,37,4
350,196,גיבתון,11,8,3
350,1043,גיזו,14,8,6
370,1204,גילון,30,77,-47
310,736,גילת,50,33,17
330,262,גינוסר,34,27,7
330,92,גיניגר,25,24,1
310,863,גינתון,45,52,-7
370,1206,גיתה,14,6,8
310,3613,גיתית,43,3,40
330,393,גלאון,18,22,-4
330,3606,גלגל,6,6,0
330,346,גליל ים,17,3,14
330,369,גלעד (אבן יצחק),10,11,-1
310,745,גמזו,38,71,-33
310,1072,גן הדרום,24,14,10
310,225,גן השומרון,38,45,-7
310,239,גן חיים,44,50,-6
310,734,גן יאשיה,25,25,0
160,166,גן יבנה,1028,740,288
190,1274,גן נר,75,86,-11
310,311,גן שורק,22,4,18
330,144,גן שלמה,13,3,10
330,72,גן שמואל,6,5,1
310,836,גנות,43,53,-10
350,549,גנות הדר,56,40,16
350,1103,גני הדר,24,14,10
370,1371,גני טל,99,38,61
310,862,גני יוחנן,35,36,-1
190,3823,גני מודיעין,266,250,16
350,218,גני עם,26,13,13
170,229,גני תקווה,1721,660,1061
330,842,געש,20,7,13
330,463,געתון,59,11,48
310,39,גפן,38,13,25
330,1129,גרופית,13,29,-16
330,4022,גשור,30,28,2
330,305,גשר,35,31,4
330,574,גשר הזיו,46,49,-3
350,128,גת רימון,15,22,-7
270,494,דאלית אל-כרמל,102,73,29
310,146,דבורה,24,33,-9
270,489,דבורייה,82,75,7
330,849,דבירה,48,30,18
330,407,דברת,51,10,41
330,62,דגניה א',22,19,3
330,79,דגניה ב',28,24,4
310,1067,"דוב""ב",7,22,-15
370,3747,דולב,46,77,-31
310,738,דור,27,20,7
330,336,דורות,50,27,23
450,475,דחי,14,8,6
270,490,דייר אל-אסד,95,67,28
280,492,דייר חנא,79,82,-3
440,493,דייר ראפאת,6,2,4
160,2200,דימונה,588,854,-266
310,2063,דישון,11,17,-6
330,300,דלייה,16,21,-5
310,431,דלתון,11,30,-19
450,1317,דמיידה,8,2,6
330,303,דן,43,19,24
330,302,דפנה,41,32,9
310,1241,דקל,6,13,-7
450,1349,דריג'את,35,7,28
330,702,האון,5,15,-10
320,675,הבונים,27,21,6
330,356,הגושרים,32,33,-1
310,191,הדר עם,59,33,26
150,9700,הוד השרון,3391,1833,1558
340,1322,הודיות,12,12,0
310,726,הודייה,33,49,-16
370,1186,הושעיה,57,60,-3
330,250,הזורע,21,22,-1
310,307,הזורעים,66,46,20
330,434,החותרים,32,13,19
310,684,היוגב,39,18,21
370,1208,הילה,36,28,8
330,377,המעפיל,37,45,-8
330,677,הסוללים,56,33,23
330,423,העוגן,19,6,13
190,3769,הר אדר,252,171,81
370,3603,הר גילה,66,32,34
330,1261,הר עמשא,35,2,33
330,464,הראל,19,13,6
330,1249,הרדוף,10,24,-14
150,6400,הרצלייה,3874,3713,161
370,1203,הררית,37,24,13
310,3639,ורד יריחו,29,21,8
350,1133,ורדון,28,7,21
310,815,זבדיאל,16,25,-9
310,44,זוהר,11,15,-4
330,584,זיקים,52,32,20
310,788,זיתן,50,50,0
160,9300,זכרון יעקב,891,772,119
310,799,זכריה,44,42,2
280,1290,זמר,69,92,-23
310,1065,זמרת,73,26,47
310,816,זנוח,11,37,-26
310,2064,זרועה,64,32,32
280,975,זרזיר,81,85,-4
310,818,זרחיה,17,22,-5
450,1321,ח'ואלד,9,1,8
310,235,חבצלת השרון,27,37,-10
350,1110,חבר,52,12,40
310,717,חגור,53,43,10
370,3764,חגי,26,28,-2
310,205,חגלה,37,16,21
370,4026,חד-נס,78,57,21
310,618,חדיד,22,36,-14
150,6500,חדרה,3596,2254,1342
330,160,חולדה,64,25,39
140,6600,חולון,5211,5819,-608
330,1239,חולית,15,11,4
330,253,חולתה,48,28,20
310,662,חוסן,119,54,65
450,1332,חוסנייה,16,22,-6
350,115,חופית,52,48,4
330,374,חוקוק,38,52,-14
270,1303,חורה,165,125,40
280,496,חורפיש,28,38,-10
330,355,חורשים,5,6,-1
310,1047,חזון,23,15,8
310,219,חיבת ציון,57,46,11
370,3643,חיננית,45,67,-22
130,4000,חיפה,7155,9770,-2615
310,162,חירות,42,40,2
370,1272,חלוץ,42,21,21
370,3573,חלמיש,36,38,-2
310,820,חלץ,11,16,-5
450,993,חמאם,8,14,-6
310,801,חמד,56,52,4
330,343,חמדיה,8,27,-19
370,3646,חמדת,11,9,2
310,3609,חמרה,7,15,-8
310,807,חניאל,47,39,8
330,280,חניתה,29,27,2
330,1257,חנתון,79,18,61
370,4005,חספין,63,63,0
330,363,חפץ חיים,11,32,-21
330,90,חפצי-בה,117,15,102
310,700,חצב,75,50,25
310,13,חצבה,14,30,-16
330,406,חצור-אשדוד,19,10,9
180,2034,חצור הגלילית,245,326,-81
330,397,חצרים,17,33,-16
310,422,חרב לאת,43,57,-14
350,1024,חרוצים,51,33,18
350,1247,חריש,452,75,377
370,3717,חרמש,16,10,6
370,1209,חרשים,20,6,14
190,3770,חשמונאים,179,219,-40
160,6700,טבריה,1237,1605,-368
280,962,טובא-זנגרייה,53,44,9
270,498,טורעאן,90,111,-21
260,2730,טייבה,169,163,6
450,497,טייבה (בעמק),15,18,-3
260,2720,טירה,162,127,35
310,663,טירת יהודה,29,26,3
160,2100,טירת כרמל,1015,405,610
330,268,טירת צבי,27,38,-11
370,1181,טל-אל,59,50,9
310,462,טל שחר,72,64,8
330,1177,טללים,43,15,28
190,3788,טלמון,226,114,112
260,8900,טמרה,192,171,21
450,547,טמרה (יזרעאל),10,11,-1
370,3743,טנא,54,52,2
310,1214,טפחות,13,28,-15
280,1295,יאנוח-ג'ת,52,57,-5
310,1232,יבול,19,29,-10
190,46,יבנאל,121,145,-24
160,2660,יבנה,2038,1288,750
330,96,יגור,31,79,-48
310,798,יגל,46,52,-6
190,577,יד בנימין,140,160,-20
320,1134,יד השמונה,99,1,98
330,758,יד חנה,69,32,37
330,358,יד מרדכי,70,38,32
310,775,יד נתן,28,19,9
310,64,"יד רמב""ם",49,51,-2
160,9400,יהוד,932,1094,-162
330,1158,יהל,32,33,-1
310,2009,יובל,16,42,-26
370,1226,יובלים,66,39,27
320,1112,יודפת,38,22,16
320,4007,יונתן,45,12,33
310,803,יושיביה,24,18,6
330,452,יזרעאל,16,23,-7
330,409,יחיעם,63,30,33
330,866,יטבתה,31,23,8
320,3607,"ייט""ב",29,6,23
310,811,יכיני,28,21,7
310,753,ינוב,24,39,-15
310,2011,ינון,40,45,-5
350,29,יסוד המעלה,101,95,6
320,440,יסודות,15,27,-12
330,575,יסעור,68,13,55
310,1138,יעד,23,40,-17
350,1044,יעף,31,13,18
310,795,יערה,36,42,-6
270,499,יפיע,227,246,-19
310,3566,יפית,5,14,-9
330,134,יפעת,106,32,74
330,453,יפתח,16,31,-15
370,3749,יצהר,54,95,-41
310,759,יציץ,50,52,-2
330,417,יקום,9,5,4
370,3647,יקיר,77,77,0
310,241,יקנעם (מושבה),71,61,10
160,240,יקנעם עילית,945,596,349
330,623,יראון,20,31,-11
310,2026,ירדנה,20,16,4
180,831,ירוחם,356,306,50
120,3000,ירושלים,9702,17654,-7952
310,718,ירחיב,35,38,-3
270,502,ירכא,58,56,2
310,183,ירקונה,7,34,-27
310,916,ישע,12,18,-6
310,805,ישעי,33,22,11
310,828,ישרש,63,52,11
310,1227,יתד,35,7,28
270,504,כאבול,109,75,34
290,505,כאוכב אבו אל-היג'א,32,28,4
330,576,כברי,50,30,20
340,371,כדורי,11,35,-24
370,1338,כדיתה,15,19,-4
370,3564,כוכב השחר,79,47,32
180,1224,כוכב יאיר,345,489,-144
180,3779,כוכב יעקב,348,299,49
310,824,כוכב מיכאל,48,26,22
350,1252,כורזים,11,18,-7
310,1210,כחל,36,22,14
450,1367,כחלה,25,1,24
330,840,כיסופים,45,25,20
330,1153,כישור,4,1,3
370,1183,כליל,67,25,42
310,1229,כלנית,11,1,10
450,1331,כמאנה,15,16,-1
310,1291,כמהין,9,9,0
370,1201,כמון,31,33,-2
340,2006,כנות,8,6,2
310,4028,כנף,33,10,23
350,63,כנרת (מושבה),47,18,29
330,57,כנרת (קבוצה),18,25,-7
270,1059,כסיפה,134,110,24
310,859,כסלון,20,37,-17
280,1296,כסרא-סמיע,52,45,7
280,978,כעביה-טבאש-חג'אג'רה,56,40,16
310,857,כפר אביב,32,26,6
190,3638,כפר אדומים,164,112,52
310,364,כפר אוריה,39,63,-24
310,690,כפר אחים,51,21,30
310,220,כפר ביאליק,65,16,49
310,177,"כפר ביל""ו",80,63,17
330,357,כפר בלום,34,22,12
310,2010,כפר בן נון,53,26,27
290,633,כפר ברא,22,39,-17
310,132,כפר ברוך,32,13,19
310,106,כפר גדעון,14,6,8
340,427,כפר גלים,9,10,-1
330,310,כפר גליקסון,10,12,-2
330,76,כפר גלעדי,27,26,1
320,707,כפר דניאל,35,26,9
190,3796,כפר האורנים,62,97,-35
330,192,כפר החורש,37,20,17
330,254,כפר המכבי,15,20,-5
310,582,כפר הנגיד,38,69,-31
340,890,כפר הנוער הדתי,4,20,-16
330,443,כפר הנשיא,46,22,24
310,187,כפר הס,47,42,5
310,217,"כפר הרא""ה",37,52,-15
310,888,"כפר הרי""ף",50,61,-11
191,190,כפר ויתקין,86,104,-18
310,320,כפר ורבורג,45,48,-3
180,1263,כפר ורדים,350,268,82
340,1325,כפר זוהרים,8,4,4
310,786,כפר זיתים,29,33,-4
180,696,"כפר חב""ד",136,165,-29
310,609,כפר חושן,19,32,-13
320,255,כפר חיטים,21,48,-27
310,193,כפר חיים,17,22,-5
370,1297,כפר חנניה,68,18,50
310,112,כפר חסידים א',43,60,-17
350,889,כפר חסידים ב',11,15,-4
330,4004,כפר חרוב,34,10,24
310,673,כפר טרומן,39,69,-30
280,507,כפר יאסיף,190,172,18
310,233,כפר ידידיה,24,28,-4
310,140,כפר יהושע,46,14,32
160,168,כפר יונה,1031,773,258
310,85,כפר יחזקאל,47,66,-19
310,170,כפר יעבץ,26,31,-5
290,508,כפר כמא,36,6,30
260,509,כפר כנא,138,175,-37
310,387,כפר מונש,33,52,-19
310,1095,כפר מימון,26,6,20
310,98,"כפר מל""ל",26,45,-19
270,510,כפר מנדא,91,79,12
330,297,כפר מסריק,27,18,9
290,512,כפר מצר,5,18,-13
310,764,כפר מרדכי,29,36,-7
310,316,כפר נטר,116,78,38
330,345,כפר סאלד,27,23,4
150,6900,כפר סבא,4132,3212,920
340,107,כפר סילבר,19,36,-17
310,249,כפר סירקין,94,63,31
330,845,כפר עזה,25,42,-17
330,3488,כפר עציון,24,15,9
310,189,כפר פינס,39,21,18
260,634,כפר קאסם,92,113,-21
310,388,כפר קיש,33,25,8
270,654,כפר קרע,183,151,32
330,579,כפר ראש הנקרה,101,23,78
310,1130,כפר רוזנואלד (זרעית),6,3,3
330,295,כפר רופין,45,19,26
310,1166,כפר רות,14,13,1
310,605,כפר שמאי,44,30,14
310,743,כפר שמואל,21,42,-21
350,267,כפר שמריהו,166,108,58
190,47,כפר תבור,332,189,143
370,3572,כפר תפוח,47,42,5
370,1285,כרכום,24,40,-16
310,664,כרם בן זמרה,22,11,11
350,88,כרם בן שמן,5,4,1
340,1094,כרם יבנה (ישיבה),27,55,-28
310,580,"כרם מהר""ל",48,48,0
330,1085,כרם שלום,7,2,5
350,1264,כרמי יוסף,95,82,13
370,3766,כרמי צור,51,39,12
160,1139,כרמיאל,1408,1682,-274
330,768,כרמייה,54,63,-9
330,1198,כרמים,36,1,35
320,3656,כרמל,23,40,-17
350,1207,לבון,54,26,28
330,585,לביא,7,34,-27
310,1230,לבנים,30,40,-10
330,2023,להב,67,54,13
330,380,להבות הבשן,39,57,-18
330,715,להבות חביבה,15,12,3
180,1271,להבים,193,271,-78
150,7000,לוד,1701,2412,-711
310,52,לוזית,39,21,18
330,595,לוחמי הגיטאות,87,15,72
330,1171,לוטם,43,32,11
330,1255,לוטן,36,26,10
310,674,לימן,39,50,-11
310,24,לכיש,41,23,18
190,1310,לפיד,44,86,-42
310,1173,לפידות,6,13,-7
270,1060,לקיה,136,117,19
310,2055,מאור,55,61,-6
340,102,מאיר שפיה,5,28,-23
320,771,מבוא ביתר,57,26,31
370,3569,מבוא דותן,37,22,15
192,3709,מבוא חורון,100,57,43
330,4204,מבוא חמה,45,14,31
370,1141,מבוא מודיעים,1,14,-13
340,1318,מבואות ים,2,9,-7
350,1080,מבועים,65,71,-6
310,829,מבטחים,14,6,8
310,573,מבקיעים,41,16,25
160,1015,מבשרת ציון,894,1181,-287
270,516,מג'ד אל-כרום,109,96,13
270,4201,מג'דל שמס,101,54,47
260,481,מגאר,120,153,-33
310,689,מגדים,58,49,9
350,65,מגדל,106,63,43
160,874,מגדל העמק,716,908,-192
330,3561,מגדל עוז,23,43,-20
370,3751,מגדלים,45,23,22
330,586,מגידו,16,28,-12
330,375,מגל,39,26,13
330,695,מגן,8,22,-14
310,1155,מגן שאול,28,22,6
310,722,מגשימים,45,51,-6
310,2029,מדרך עוז,39,33,6
350,1140,מדרשת בן גוריון,105,56,49
340,897,מדרשת רופין,0,4,-4
150,1200,מודיעין-מכבים-רעות*,2697,2540,157
150,3797,מודיעין עילית,1324,1257,67
450,1360,מולדה*,33,1,32
320,269,מולדת,65,40,25
350,208,מוצא עילית,56,38,18
290,635,מוקייבלה,57,29,28
330,1163,מורן,26,25,1
370,1178,מורשת,34,45,-11
310,606,מזור,57,72,-15
170,28,מזכרת בתיה,876,337,539
330,104,מזרע,13,22,-9
290,517,מזרעה,54,40,14
310,3599,מחולה,32,24,8
350,1196,מחנה יתיר,4,5,-1
330,308,מחניים,43,33,10
310,776,מחסיה,17,28,-11
350,43,מטולה,113,146,-33
310,822,מטע,51,57,-6
320,1128,מי עמי,8,7,1
310,2054,מיטב,14,27,-13
450,649,מייסר,28,25,3
310,4019,מיצר,24,4,20
330,1282,מירב,11,9,2
310,607,מירון,31,45,-14
310,731,מישר,40,24,16
180,1268,מיתר,444,372,72
310,3614,מכורה,4,5,-1
450,1343,מכחול,24,6,18
310,382,מכמורת,52,53,-1
370,1202,מכמנים,56,25,31
310,164,מלאה,4,10,-6
310,2044,מלילות,43,16,27
330,596,מלכייה,24,26,-2
310,2030,מנוחה,23,9,14
310,1174,מנוף,47,17,30
310,1205,מנות,23,29,-6
350,48,מנחמיה,47,73,-26
330,347,מנרה,27,30,-3
450,994,מנשית זבדה,25,9,16
370,1258,מסד,45,18,27
330,263,מסדה,49,17,32
330,298,מסילות,25,32,-7
310,742,מסילת ציון,40,58,-18
310,748,מסלול,44,17,27
290,4203,מסעדה,27,34,-7
330,197,מעברות,15,18,-3
190,1082,מעגלים,105,68,37
330,678,מעגן,24,16,8
330,694,מעגן מיכאל,19,86,-67
330,272,מעוז חיים,28,20,8
320,3657,מעון,48,44,4
310,570,מעונה,62,66,-4
330,416,מעיין ברוך,29,59,-30
330,290,מעיין צבי,28,31,-3
290,518,מעיליא,15,40,-25
160,3616,מעלה אדומים,906,1495,-589
350,3608,מעלה אפרים,68,99,-31
330,1127,מעלה גלבוע,57,15,42
310,4008,מעלה גמלא,37,17,20
330,286,מעלה החמישה,37,16,21
370,3752,מעלה לבונה,34,29,5
370,3651,מעלה מכמש,51,61,-10
270,1327,מעלה עירון,107,120,-13
370,3653,מעלה עמוס,31,43,-12
370,3637,מעלה שומרון,52,63,-11
160,1063,מעלות-תרשיחא,463,870,-407
330,344,מענית,29,21,8
310,230,מעש,35,40,-5
330,668,מפלסים,55,23,32
320,3745,מצדות יהודה,7,11,-4
330,325,מצובה,67,29,38
310,757,מצליח,44,44,0
350,58,מצפה,8,18,-10
370,1222,"מצפה אבי""ב",38,37,1
370,1370,מצפה אילן,39,1,38
190,3576,מצפה יריחו,83,132,-49
370,1190,מצפה נטופה,40,32,8
180,99,מצפה רמון,316,381,-65
330,3610,מצפה שלם,10,9,1
330,648,מצר,24,34,-10
340,22,מקווה ישראל,20,34,-14
310,843,מרגליות,23,17,6
330,4101,מרום גולן,35,15,20
370,1340,מרחב עם,63,1,62
310,97,מרחביה (מושב),25,21,4
330,66,מרחביה (קיבוץ),52,141,-89
190,1098,מרכז שפירא,43,102,-59
330,421,משאבי שדה,14,60,-46
310,765,משגב דב,60,29,31
330,378,משגב עם,21,29,-8
280,520,משהד,47,96,-49
310,3605,משואה,12,7,5
320,620,משואות יצחק,6,5,1
370,3785,משכיות,24,3,21
310,670,משמר איילון,20,17,3
330,563,משמר דוד,65,5,60
310,732,משמר הירדן,54,23,31
330,395,משמר הנגב,11,39,-28
330,130,משמר העמק,13,51,-38
310,729,משמר השבעה,62,62,0
330,194,משמר השרון,4,23,-19
330,213,משמרות,54,29,25
310,425,משמרת,37,36,1
310,791,משען,41,19,22
190,1315,מתן,68,139,-71
370,1184,מתת,1,2,-1
320,3648,מתתיהו,88,20,68
310,4551,נאות גולן,58,39,19
310,1124,נאות הכיכר,11,9,2
330,408,נאות מרדכי,50,36,14
330,1197,נאות סמדר,15,9,6
290,524,נאעורה,15,17,-2
330,315,נגבה,27,4,23
370,3724,נגוהות,15,12,3
350,309,נהורה,62,59,3
310,80,נהלל,66,58,8
150,9100,נהרייה,1865,2043,-178
310,4304,נוב,17,35,-18
310,55,נוגה,22,22,0
310,1366,נווה,13,10,3
330,590,נווה אור,10,19,-9
310,4303,"נווה אטי""ב",10,25,-15
320,405,נווה אילן,42,53,-11
330,296,נווה איתן,12,25,-13
190,3725,נווה דניאל,94,102,-8
350,1057,נווה זוהר,4,2,2
370,1314,נווה זיו,85,38,47
330,1279,נווה חריף,5,2,3
330,312,נווה ים,7,12,-5
310,686,נווה ימין,118,95,23
310,858,נווה ירק,68,88,-20
310,827,נווה מבטח,31,30,1
310,1071,נווה מיכאל,82,17,65
350,1259,נווה שלום,15,13,2
310,15,נועם,11,18,-7
190,1333,נוף איילון,86,93,-7
350,3790,נופים,58,26,32
190,1284,נופית,68,117,-49
370,257,נופך,21,33,-12
190,3726,נוקדים,123,114,9
320,447,נורדייה,91,124,-33
370,833,נורית,46,3,43
310,59,נחושה,79,20,59
330,844,נחל עוז,22,46,-24
310,2045,נחלה,60,11,49
370,3767,נחליאל,10,48,-38
310,449,נחלים,46,72,-26
310,809,נחם,12,9,3
270,522,נחף,69,71,-2
330,433,נחשולים,40,34,6
330,777,נחשון,32,5,27
330,705,נחשונים,35,12,23
310,1147,נטועה,7,6,1
310,4014,נטור,16,1,15
370,1369,נטע,13,8,5
310,174,נטעים,30,27,3
370,1254,נטף,25,13,12
450,523,ניין,23,26,-3
370,3655,"ניל""י",154,54,100
350,351,ניצן,204,112,92
350,1419,ניצן ב',8,287,-279
340,1195,ניצנה (קהילת חינוך),9,80,-71
310,1280,ניצני סיני,9,2,7
310,851,ניצני עוז,38,52,-14
330,359,ניצנים,31,18,13
330,808,ניר אליהו,13,5,8
310,553,ניר בנים,36,24,12
320,720,ניר גלים,70,17,53
330,256,ניר דוד (תל עמל),25,8,17
310,11,"ניר ח""ן",44,17,27
310,165,ניר יפה,11,26,-15
330,402,ניר יצחק,22,35,-13
310,699,ניר ישראל,37,33,4
310,2047,ניר משה,54,26,28
330,69,ניר עוז,19,24,-5
330,348,ניר עם,35,18,17
310,2048,ניר עקיבא,55,31,24
310,331,ניר צבי,53,63,-10
330,602,נירים,31,22,9
370,1236,נירית,41,239,-198
330,3620,נירן,4,0,4
310,825,נס הרים,75,46,29
350,1143,נס עמים,147,4,143
160,7200,נס ציונה,1782,1143,639
340,186,נעורים,20,34,-14
350,3787,נעלה,119,57,62
310,3713,"נעמ""ה",1,5,-4
330,158,נען,33,38,-5
310,1372,נצר חזני,12,14,-2
330,435,נצר סרני,22,3,19
250,7300,נצרת,617,1161,-544
160,1061,נצרת עילית,1316,1688,-372
160,2500,נשר,1060,1175,-115
310,3555,נתיב הגדוד,12,6,6
330,693,"נתיב הל""ה",10,7,3
310,1242,נתיב העשרה,45,34,11
310,792,נתיב השיירה,35,29,6
160,246,נתיבות,1523,1033,490
130,7400,נתניה,5022,5716,-694
290,525,סאג'ור,52,48,4
330,578,סאסא,9,8,1
190,587,סביון*,250,193,57
310,2046,סגולה,21,17,4
450,942,סואעד (חמרייה)*,1,1,0
290,526,סולם,31,37,-6
370,3756,סוסיה,90,44,46
330,1238,סופה,11,36,-25
260,7500,סח'נין,269,174,95
290,1245,סלמה,36,38,-2
310,3567,סלעית,118,10,108
330,1156,סמר,19,15,4
370,3777,סנסנה,51,1,50
330,419,סעד,34,33,1
330,454,סער,56,43,13
350,1176,ספיר,35,30,5
310,610,סתרייה,73,61,12
290,4501,ע'ג'ר,0,4,-4
310,892,עבדון,26,24,2
330,376,עברון,15,8,7
310,794,עגור,14,16,-2
370,1199,עדי,101,73,28
310,2035,עדנים,28,26,2
310,826,עוזה,8,23,-15
290,528,עוזייר,27,34,-7
310,737,עולש,72,55,17
180,666,עומר,437,307,130
310,810,עופר,11,35,-24
310,32,עוצם,11,14,-3
370,328,עזוז,0,1,-1
350,1149,עזר,17,33,-16
310,837,עזריאל,52,26,26
310,711,עזריה,58,51,7
310,817,עזריקם,49,31,18
370,3658,עטרת,14,37,-23
310,1175,עידן,15,8,7
280,530,עיילבון,62,74,-12
340,156,עיינות,8,135,-127
280,511,עילוט,67,52,15
310,687,עין איילה,63,43,20
450,546,עין אל-אסד,7,15,-8
330,273,עין גב,24,18,6
330,2042,עין גדי,26,18,8
330,436,עין דור,55,34,21
310,1240,עין הבשור,75,43,32
370,74,עין הוד,29,20,9
330,167,עין החורש,32,9,23
330,289,עין המפרץ,10,7,3
330,383,"עין הנצי""ב",21,22,-1
350,367,עין העמק,28,21,7
330,270,עין השופט,10,50,-40
330,676,עין השלושה,16,28,-12
310,157,עין ורד,45,59,-14
330,4503,עין זיוון,22,9,13
450,1320,עין חוד,48,59,-11
330,89,עין חרוד (איחוד),6,14,-8
330,82,עין חרוד (מאוחד),33,30,3
310,806,עין יהב,28,21,7
310,813,עין יעקב,62,49,13
340,1056,"עין כרם-בי""ס חקלאי",2,1,1
330,426,עין כרמל,11,7,4
270,532,עין מאהל,42,61,-19
290,521,עין נקובא,51,27,24
310,223,עין עירון,33,27,6
330,622,עין צורים,75,78,-3
450,4502,עין קנייא,21,12,9
450,514,עין ראפה,17,6,11
330,139,עין שמר,9,32,-23
350,880,עין שריד,105,77,28
310,1251,עין תמר,13,13,0
330,871,עינת,11,26,-15
160,7600,עכו,856,1596,-740
330,1146,עלומים,16,30,-14
190,3765,עלי,244,302,-58
370,3727,עלי זהב,325,42,283
310,688,עלמה,18,33,-15
370,3715,עלמון,56,53,3
370,1212,עמוקה,8,9,-1
310,779,עמינדב,89,58,31
330,385,עמיעד,10,14,-4
310,318,עמיעוז,13,7,6
310,773,עמיקם,30,27,3
330,319,עמיר,48,38,10
190,3660,עמנואל,173,267,-94
310,708,עמקה,73,26,47
370,3712,ענב,38,27,11
270,534,עספיא,134,123,11
160,7700,עפולה,2361,1269,1092
190,3617,עפרה,106,113,-7
190,3778,עץ אפרים,194,42,152
370,917,עצמון שגב,178,108,70
260,531,עראבה,151,121,30
450,1246,עראמשה*,28,26,2
450,1335,ערב אל נעים,15,4,11
160,2560,ערד,902,974,-72
310,593,ערוגות,54,43,11
260,637,ערערה,146,181,-35
270,1192,ערערה-בנגב,155,174,-19
350,591,עשרת,61,57,4
180,53,עתלית,372,226,146
370,3748,עתניאל,25,50,-25
310,1151,פארן,15,18,-3
370,3768,פדואל,115,58,57
310,750,פדויים,11,5,6
310,838,פדיה,25,47,-22
270,537,פוריידיס,70,68,2
350,1104,פורייה - כפר עבודה,17,16,1
350,1105,פורייה - נווה עובד,76,40,36
350,1313,פורייה עילית,130,49,81
310,767,פורת,48,36,12
310,749,פטיש,25,35,-10
330,1185,פלך,6,5,1
330,597,פלמחים,41,14,27
370,3723,פני חבר,11,17,-6
370,3659,פסגות,51,166,-115
290,535,פסוטה,21,28,-7
310,2059,"פעמי תש""ז",34,18,16
310,3615,פצאל,4,10,-6
280,536,פקיעין (בוקייעה),25,28,-3
310,281,פקיעין חדשה,69,55,14
160,7800,פרדס חנה-כרכור,2075,1158,917
180,171,פרדסייה,409,282,127
330,599,פרוד,60,40,20
310,2053,פרזון,16,13,3
310,1231,פרי גן,10,1,9
130,7900,פתח תקווה,7926,6578,1348
310,839,פתחיה,21,42,-21
330,413,צאלים,17,20,-3
370,1180,צביה,10,12,-2
330,1213,צבעון,15,7,8
330,465,צובה,5,53,-48
350,1136,צוחר,35,31,4
190,3791,צופים,149,75,74
310,198,צופית,43,64,-21
310,1150,צופר,14,21,-7
350,1102,צוקי ים,16,14,2
370,1262,צוקים,19,13,6
180,1113,צור הדסה,512,230,282
190,1345,צור יצחק,764,262,502
190,276,צור משה,121,126,-5
320,1148,צור נתן,15,16,-1
310,774,צוריאל,16,30,-14
370,1221,צורית,99,49,50
310,613,ציפורי,78,42,36
310,796,צלפון,53,57,-4
450,636,צנדלה,10,24,-14
310,594,צפרייה,45,55,-10
310,1079,צפרירים,21,28,-7
160,8000,צפת,1195,1894,-699
310,612,צרופה,63,49,14
330,567,צרעה,12,29,-17
330,334,קבוצת יבנה,11,40,-29
190,3557,קדומים,108,178,-70
160,195,קדימה-צורן,1169,646,523
340,392,קדמה,6,7,-1
310,4025,קדמת צבי,51,20,31
370,3781,קדר,127,88,39
310,615,קדרון,51,57,-6
330,1211,קדרים,22,5,17
310,766,קוממיות,8,17,-9
370,1179,קורנית,23,27,-4
330,1052,קטורה,17,35,-18
190,1167,קיסריה,376,287,89
310,414,קלחים,39,35,4
330,3601,קליה,10,22,-12
260,638,קלנסווה,130,129,1
370,4024,קלע,39,22,17
190,1243,קציר,170,125,45
450,1347,קצר א-סר,106,2,104
180,4100,קצרין,319,375,-56
160,2620,קריית אונו,1865,1476,389
180,3611,קריית ארבע,309,438,-129
150,6800,קריית אתא,1919,1519,400
160,9500,קריית ביאליק,1812,1837,-25
150,2630,קריית גת,1238,1382,-144
170,2300,קריית טבעון,597,667,-70
160,9600,קריית ים,1497,1966,-469
190,1137,קריית יערים,204,225,-21
340,2039,קריית יערים (מוסד),7,1,6
160,8200,קריית מוצקין,2144,1892,252
160,1034,קריית מלאכי,569,717,-148
370,3746,קריית נטפים,31,22,9
330,78,קריית ענבים,19,27,-8
170,469,קריית עקרון,392,510,-118
340,412,קריית שלמה,3,0,3
160,2800,קריית שמונה,496,914,-418
180,3640,קרני שומרון,364,326,38
320,4006,קשת,59,45,14
280,543,ראמה,105,118,-13
450,1334,ראס אל-עין,4,9,-5
450,990,ראס עלי,10,5,5
160,2640,ראש העין,2875,993,1882
190,26,ראש פינה,188,153,35
330,3602,ראש צורים,18,38,-20
130,8300,ראשון לציון,7185,7561,-376
190,3795,רבבה,224,64,160
330,564,רבדים,23,12,11
330,354,רביבים,23,48,-25
330,1225,רביד,0,7,-7
320,390,רגבה,49,44,5
330,444,רגבים,28,10,18
250,1161,רהט,396,305,91
310,2051,רווחה,22,22,0
310,2016,רוויה,45,12,33
330,362,רוחמה,35,16,19
450,539,רומאנה,10,16,-6
450,997,רומת הייב,39,34,5
310,3619,רועי,3,1,2
370,3782,רותם,22,1,21
310,854,רחוב,29,10,19
140,8400,רחובות,5076,3789,1287
370,3822,רחלים,101,30,71
450,540,ריחאנייה,9,29,-20
320,3568,ריחן,23,16,7
270,542,ריינה,156,266,-110
370,3565,רימונים,58,51,7
310,616,רינתיה,68,62,6
170,922,רכסים,386,365,21
310,1069,רם-און,21,41,-20
310,4702,רמות,30,25,5
350,206,רמות השבים,108,110,-2
310,735,רמות מאיר,22,42,-20
330,445,רמות מנשה,27,22,5
310,372,רמות נפתלי,29,21,8
150,8500,רמלה,1809,2052,-243
140,8600,רמת גן,7994,8240,-246
330,135,רמת דוד,34,49,-15
330,184,רמת הכובש,21,9,12
330,335,רמת השופט,32,24,8
160,2650,רמת השרון,1669,1876,-207
330,178,רמת יוחנן,25,31,-6
180,122,רמת ישי,338,339,-1
320,4701,רמת מגשימים,37,16,21
310,339,רמת צבי,45,17,28
310,460,רמת רזיאל,34,59,-25
330,127,רמת רחל,32,9,23
310,789,רנן,45,10,35
330,713,רעים,9,6,3
150,8700,רעננה,2742,3330,-588
370,1228,רקפת,50,21,29
310,247,רשפון,81,81,0
330,437,רשפים,111,7,104
370,1260,רתמים,8,15,-7
310,324,שאר ישוב,59,33,26
320,282,שבי ציון,42,45,-3
370,3571,שבי שומרון,23,51,-28
280,913,שבלי - אום אל-גנם,52,56,-4
280,1286,שגב-שלום,33,29,4
310,721,שדה אילן,23,15,8
330,304,שדה אליהו,30,73,-43
310,861,שדה אליעזר,66,54,12
330,885,שדה בוקר,25,30,-5
310,36,שדה דוד,23,14,9
310,284,שדה ורבורג,61,76,-15
330,293,שדה יואב,15,5,10
310,142,שדה יעקב,55,50,5
310,2008,שדה יצחק,22,31,-9
310,18,שדה משה,30,19,11
330,259,שדה נחום,68,12,56
330,329,שדה נחמיה,87,39,48
310,1058,שדה ניצן,12,12,0
310,739,שדה עוזיהו,28,31,-3
310,2049,שדה צבי,47,44,3
330,327,שדות ים,24,10,14
310,27,שדות מיכה,22,8,14
310,1223,שדי אברהם,14,13,1
310,2015,שדי חמד,42,48,-6
310,2057,שדי תרומות,10,6,4
310,555,שדמה,48,34,14
310,306,שדמות דבורה,43,29,14
320,3578,שדמות מחולה,40,34,6
160,1031,שדרות,1148,698,450
310,741,שואבה,42,27,15
310,761,שובה,54,25,29
330,394,שובל,47,27,20
160,1304,שוהם,772,586,186
310,614,שומרה,14,11,3
330,1265,שומרייה,42,30,12
310,415,שוקדה,53,19,34
320,456,שורש,166,42,124
320,1235,שורשים,28,12,16
350,224,שושנת העמקים,16,28,-12
310,527,שזור,26,12,14
310,7,שחר,39,19,20
370,1266,שחרות,4,2,2
310,865,שיבולים,28,11,17
290,658,שייח' דנון,17,46,-29
190,3641,שילה,229,139,90
310,1165,שילת,44,46,-2
370,1160,שכניה,48,29,19
310,873,שלווה,8,15,-7
330,439,שלוחות,33,38,-5
180,812,שלומי,317,388,-71
370,1364,שלומית,32,2,30
330,366,שמיר,10,18,-8
370,3784,שמעה,58,15,43
330,432,שמרת,24,7,17
190,1337,שמשית,50,72,-22
370,1287,שני,39,19,20
330,1132,שניר,9,23,-14
280,538,שעב,52,59,-7
310,4009,שעל,4,13,-9
330,856,שעלבים,55,61,-6
310,661,שער אפרים,82,52,30
330,264,שער הגולן,10,43,-33
330,237,שער העמקים,8,7,1
340,921,שער מנשה,9,3,6
180,3720,שערי תקווה,303,219,84
330,232,שפיים,20,7,13
310,692,שפיר,55,30,25
310,846,שפר,23,19,4
260,8800,שפרעם,342,312,30
370,3649,שקד,48,46,2
310,1233,שקף,32,20,12
310,292,שרונה,24,44,-20
350,1114,שריגים (לי-און),64,71,-7
330,126,שריד,30,17,13
310,398,שרשרת,35,21,14
310,1045,שתולה,14,19,-5
310,763,שתולים,84,88,-4
310,2062,תאשור,22,12,10
310,2061,תדהר,62,22,40
330,1172,תובל,18,10,8
310,3558,תומר,13,9,4
350,1083,תושייה,35,25,10
320,163,תימורים,32,27,5
310,10,תירוש,19,21,-2
130,5000,תל אביב-יפו,19639,22108,-2469
330,84,תל יוסף,26,16,10
330,287,תל יצחק,23,8,15
170,154,תל מונד,617,461,156
310,103,תל עדשים,78,64,14
330,719,תל קציר,38,17,21
270,1054,תל שבע,88,229,-141
370,1283,תל תאומים,20,27,-7
320,3719,תלם,35,14,21
310,1051,תלמי אליהו,5,11,-6
310,2003,תלמי אלעזר,76,38,38
310,2050,"תלמי ביל""ו",28,18,10
310,1237,תלמי יוסף,20,18,2
310,727,תלמי יחיאל,46,24,22
320,744,תלמי יפה,35,27,8
310,814,תלמים,33,58,-25
370,1244,תמרת,72,136,-64
310,2002,תנובות,50,45,5
310,752,תעוז,19,16,3
191,709,תפרח,81,90,-9
310,665,תקומה,32,28,4
190,3563,תקוע,182,135,47
450,1346,תרבין א-צאנע (יישוב)*,42,0,42
310,778,תרום,32,39,-7
